Population	Superpopulation
ACB	AFR
ASW	AFR
BEB	SAS
CDX	EAS
CEU	EUR
CHB	EAS
CHS	EAS
CLM	AMR
ESN	AFR
FIN	EUR
GBR	EUR
GIH	SAS
GWD	AFR
IBS	EUR
ITU	SAS
JPT	EAS
KHV	EAS
LWK	AFR
MSL	AFR
MXL	AMR
PEL	AMR
PJL	SAS
PUR	AMR
STU	SAS
TSI	EUR
YRI	AFR
